...............
...............
...............
.............__
...............
.............__
...............
...............
...............
....___.....___
............._.
............._.
............._.
........__..._.
............._.
............._.
............._.
...........___.
...............
...............
.....__........
...............
__.............
...............
....___.....___
............._.
............._.
............._.
___..__________
___..__________
