...............
...............
...............
...............
...............
...............
...............
...............
...............
....___.....___
............._.
............._.
............._.
_______________
_______________
